****X***X****XX*********X****X***X***X****X******X***XX*****X*********X****X**X*
XXX**XX***X*****X*X*XXX*X*XX***X***X***XX**X*X*X*X*X****X*X**XX*X*X*X**X*X**X***
**XX*X*X*XX*XX*X***X***X****X*XXXXX*XXX**X**X**X*X*XX*XX*XXX***XXX**XX*X*XX**X*X
*****X*X*X***X***X***X***XXX**XX******X*X**XX*X**X***X****X*XX**X**X***X***X***X
**XXX****X*X*XXXX*X*X**XXX***X***X*X*X****X***X*X*XX*X*XX*X*X*X*X*XX*XX**X**XX**
*X***X*XX**XX******X**X****XX*XXXX**X**X*X**XXX****X***X**X***X***X***X*X*X**XX*
***X*X***X**X**X*X*XXX**XXX*******X**X*X***X***XXX**XXX**X*XX**XXX*X*X*****X***X
X*XX**XX**X*X***XX***X*X**X*XX*XX*X*X*****X**X****X*****XX***X***X***X*XXX**XX**
*X**X*X*X*X*XXX*X*XX*X*X*X**X**XX****XXXXX**X**XX**XXXXX***X*X*X*X*XX*X***X***X*
***X**X***X***X*X*XX***X***X**X**X*XX*****X**X***X******X****XX**X*X****X***X*X*
X*X*X*X*XX**X*X*****XXX**X*X**XX****X*XXX**X*X*X**XXXXX***X*X***X***X****XXX**X*
***X**X*XX*X*X**X*X*X*X*X**X*XX**XXX**X**X***XX*X*******XX**X***X*X*X*X*X***XX**
*XXX*X*****X*X****X***X**X*X***X*****X**X*XX*****X*XX*X*X****X*XX**X***X**X**X*X
*****X*XX*X**X**X**XX**X**X*XX**X*XX*X*X****XXXX*XX****X**X****X*X**X*X**XX*X***
*X*X*X*X*X**X*****X*X*X*X**X**X*X*X*X****XX****X***X*X***X*XXX****X*X*X*XX****X*
*XX*X**X***X*X**XX*******X*X*X**X*****X*X**X*X**XX**XX*X******XXX*X**XX***XXX**X
*****X***X***X*X***X*X*XX**X**X*XXXX*X*XXX**XXX***X***XX*XXXX**********XX*X*XX**
XX*X**X*X*XX*X*X*XX***X***X***X****XX***XXX**XXX*X*X****X***XXXX*XX*XX**X*X***X*
****X**X****X**X***XXX**XX*****XXX****X**X*X**XX*X***XX*X*X****X*****XX*X*X*X***
*X*X**X**XX**X**XX***X*X***X*X****XXXX*X****X*****X*X*X*X**XXX**XX*X**X*X*X**XXX
**X**X**X*XX**X**X*X*X**X*X***X*X******X*XX***X*X***X***X*X***X*X***XXX*X**X****
*X**X**X*****X*X*XXX**X**XXX*X**X*XXXX**X**XX*XX*XX**X*XX**X*X**X*XX****XX**X*X*
X**X*X***X*XXX*X****X*XX**X***XX**X***X***XX*X*****XX**X**X**X*XX*X**XXX***X***X
***X*X**X*******XXX*X**XX**X*X******XXX*X****X*XXX****X**X**X*******X****XX*XX**
X*****X**XXX*XX*X***XX***X*XX**XXXX******XXX*X*X**X*XX*X***X**XXXXX**X*XXX***XX*
*XXXX**X*X****X***XX**X**X**X*X**X**XXX*X***XX*X*XXX***X*X**XX*****X*X*****X***X
*X***X*X**XXX**XXX*XX**X**X*X**X*X*X***XX*X*X**X*XX**X*X**X**X*X*X***X*XXX*XXX**
***XX***X****XX*****X****X**XX*X*X**X*X***X***X*****X***X**X*X**X*X*XX*X**X****X
X*XX***X*XX*X***XXX**X*X***X***X**X*X*X**XXXXXX*X*XX**X**X**X*X****X***XX*X*XX**
**X**X****X***XX***X*X*X*XX*X*X**X**X*X***X****X**X*X**X*X*X***X**X**XX***X***XX
*XX*XX*XX**X*X***X***X**XX*****X**X*X**XX***XX**X****X*XX****X**X**X***X*X**X***
****X**X*X**X*X*X*XXX*X****XXXX**XX***X**XXX***X*XXX*XX***XX**X**X**XX*X**X*XXX*
*X*X**X***X***X*X*X***XXX*X*****X**XX***XX*X*XX****X****XX*X*X**X*X**X**X**X****
**XX*X**X*X*XX**X**X*X***X**XXX**X***XX****X***X*X*XXXX*X***X**X***X*XX**X*X*XXX
X****X**X*X*****XX*****X***X***X*X*X**X*X*X*XX***X*****X**X**XX**X*X***X***X****
*XXXX****X*XX*XXX***XXXXXX***X*XX***X**X**X***XX**X*XX***X*X*XX*XX**X***X*X*X*X*
******XX*****X*X**X****X**XXXX***X*X*X*X*X**X***X**X**XXX*******X**X**X**X***X**
*XXXXXX**XXX*X*X*X**XX**X*X***XX*X*X*X*X*X**X*X**X**X****XXX*X*XX*XXX*X*X**X***X
*X******X****X*****X*X*X**X*X*X**X***X***XX****X**X***X*X***X*X***XXX***XX**XX**
X**XX*XX*X*XX*X*XXX******X**X*X*X**XX*X*X***XX*X*X**XX**X*X*****X**X**XX**X*X*X*
*****X***X*X****X***XXXXX**X****X******X*X*X**X**XXXXX*X***XXXX**X**X*XXX*X****X
*X*X***X*X**XXX**XXX******X**X*X**X*XX*X***XX***X***X**X*XX***X*X*X*X**X****XX**
***X*XXX**X****XX****XXXXX**X**X*X**X**XXX**X*XX**X***X***X*X**X***X*X**XXX****X
*XX**X**X**X*X****X*X*****X**X*X*XX**X***XX*X**XX**XX*X*X*X*XX*X*X*X**X*****XX*X
***X*X*X*X***X*X*X**X*XXX**X**XX**X*X*XX*****X**XX*XX**X**X**X***X***X*X*XX**X**
*X*X******XXX****XXXX****X**X***X***X**XXXX*X*X******X*X*X*X*X*XX*XX****X**X**X*
*X**XX*X*X***XX*X****X*X**X**X*XXX*XXX****XX**X*X**X*X*X*X****XX***XX*X**X**X***
X**X*X*XX**X**X*X*XX**X**X*X*X**X***X**XX****X***XX**X*X***XX****X**X**X**X***X*
**X**X**X*XXX**X**X*X*X*X**X*XXX**X**XX*X*X*X*XX*X**X*X*XX***XX**XXX**X**X**XX**
*XXX*X*X***X*X***XX*X*****XX*****X**X****XX********X******X*X***X****X*X*X*X**X*
*XXX***X*X******XX**XXXXXXX**XXXX*XXX*XX*X**XXXXXX*XX*XXX**X**X***XXXX*X*X**X***
**X**XXX*XX*XXX****X*******X***********X*X*X*****X**X*X***X**X*X*X*****X**X*XXX*
X*X*XX*****X***XXXXX*XXXXX*X*X*XXXX*X*X**X*X*XXX**XX**X*XXXX****X***X*X*X*X*****
***X***X*XX**X*******X***X*XXX*X***X*X**X*X**X*XX****XX*X*X**XX*****X***X**X*XX*
*X*X*XXX****X*X*X*X*X*XX*******X*X***X*X****X****XXXX***X***X***X*X*X*XX*X**X***
***X***X**X*X**X***X***XX*XXXX****X*XX**X*XX**X*XX**X*XX**XX**XX**X**X*****XX*XX
*XX*X*X**X*X**XX*X*X*X**********XXX***X*X**X*X*****X**X**XX**X**X**X***X**X***X*
******X*X****X***XX**X*X**XXXX*****XX*X**X*X*XX*XX**X*X*X***XX****X*X*X**X**XX**
*X*X*X**XXX*X**XX*X*X*X********XXX**X*X*X**XX***X**X**X**X*XXX**XX***X**XX*X***X
*X**X*X***X*X*X***X***X*X**XX*X**XX***X***X***X*XXX**X*X*X**X**XX**X***X***X***X
**X****XX*X****X*X*X*X***X***XXX****X*X*XX*XX*XX****X*****X**X***XX*X*X*XX***X**
*X**X*X*X*X*XX*****X*X*XX*XX**X**X*X***X****X****XX*X*XXX*XX*X*X*X****X***XXX*X*
*X*X**X***XXX**X*X*X*X*****XX**X*X***X*X*XX**X*X***X*****X****X**X*XX*X*X*****X*
*X*X*X**XX***XX***X**XXXXX***X**X**XX*X**X*X**X*XX**X*X*X**XXX**X***X*X*X**X*X**
*X*X**X****X***X*X**X*****XX*X*X**X***X*X***X***XX*X***X**XX***X**X*X*X**X**X**X
**X**X**X*XXXX*X***X**X*XX***X*X*X**X*X**X*X***X***X*X*X*X****XX*X**X*X*X*X***X*
*X**X**X***X***X**X**X**X**XX**X**XX**XX*****X***X**X**X*X*XX***XX*X**X****XXX**
***X**X**X*X*XXX*X*XX**X**X*X*X*X***X**X*X*XXX*X*X****XX*X****X****X*XXXX*X****X
*X*XXX**X*XX*X***X****XXX*X***X***X*XX*X**X***X***X**X****XXX*XXXXX***X*X**X*X**
**X***XXX****X*XX**XX**X**X*XX*X*******X*X**X**XX*X*X**X*X***X****X*X****X*X*X**
X*X*X****X*XXX*X*X***X**X*X*X***X*XXXX*X**X*XX****X*XX*X*X*X***XX**X*XX*X**XX***
**X**XXX*X*X***X*X*X*X*X**X*X*X**XX*****X*X**X**X*X**X**X***X*X**X*X****X*X***X*
***X***X***X*XX*****X**X*XX***XX*X**X*X*X**X**X*X*XX**X*X****XXX****XXX*X****X**
X*X*XX**XX*X*X*X*X*X*****X**X**X**XX*X*XXX*X*X**X**XXX***X*X**X*XX*X***X**X**X*X
**X***X*XX***X****X**XXX*X*XXXX*X*******X**X*X*XXX****XX***X*X***X*X*X***X*X*X**
*X**X*X**X**X**X*X**X*X**X**X***X*XX*XX***X**X**XXX*X****X*X*X*X***X**X*X****XX*
*X*XX**X**X**X*X*X*X***X*X*X**X*X*X****XXX**XXX**XX**X*XXX*X*X**X*X**X*X*X*X**XX
***X**X*X**X**X*****XX*X*XXX*X**XX**XXXX***X*X*X***X**X***X**XX*XX**X*****X*X***
XXXX*X***X*X*X**XXX**X*X******X***XX*****XX*****XX**XXX*X*X***X**X*X****X****XX*
*******X*X*****XXXXX****X*X*X**XX******X****X*X***X*********X**X*****X***X*X****