***X****X*****X*XX****X****X********X******X***********X******X*X**X****X****X**
XX*X*XX***XX*X*****XX***X*XX*X*X*X*X**XXXX**X*XXXXX*X*X**XX*XX****XX*XX***XX**X*
***X*X*XXX*X***X*XXXX*X*XX****X**XXX*X****X***X****X***X**X*X**X*X***X*X*X*XX*X*
*XX********XXXX****X***X***XX*X*X****X*X*X*X*X*X*X***XX*X*X**X*X*X*XX**X*X**X*X*
*X*X*X*XXX*****XXX*X*XX**XX**X**X*XXX***X**X****X*XXXX****XX***X***X*X*X**X*X*X*
*X***XX***XXXX***X*XX***X**X*X*XX*X***X***X*XXX********XXX**XXX*XX*****XX*X***X*
*X*XX***X*****XX*X**X*XX**X**X*X***X*X**X*X****X*XXX*XXX***X****X**XXX**X**X*XX*
**X***X**X*XX*X***X*X*X*X***XX**XX**XXX**X**X*X*X***X***XX***XXX**X***XX*X*X*X**
X*X*X*XXXXX****X*XX*X***XX*X**X**XX**X**XX*X**X***X*X*X****XX***XX**X******X***X
**X*XX***X**XX**X***XXX****XX*XX****X**X***XX***XX**X*X*XXX***X**X*X*XX*XXX*XX**
*X***X*X*XXX*XX***X****XXX**X***XX*X**X**XX**X*X***X***X***XX*X*X**X*X*X******X*
*X*X***X******XX*X**XXX****X**X***XX*X**X*X*XX**X*XXX*XX*X****X*X*X******X*X*X**
*X**X*X*X*XXX**XXXXX****X*X**X*XX*****X*X*****X*X**X**X**XXX*X**X*XX*X*XXXX***X*
**X**XX**X***X***X***XXX*XXX*X*X*XX*XXX**X*X*XX**X***X**X***XX*X****XX***X**X*X*
X*XX****X**X**XX***XXX****X**X***XX****X***XX***X**X**X*X*XX***X*XX***XX**X**X**
X***XXXX**XXX*X**XX***X*X***X**X***XXX**X*X***XX**X*X*X*X****XXX*X*XX***XX*X*X*X
*XX****X*X*X**X*X***X*XX**XX*X**X*X**XX***X*XX***X**XX**X*X*XX*****X*X*X***X*X*X
***XXX***X***XX***XXX***X*X***X*X*XX***XXX**X**XX**X***XX**X***XXX***X*X*X***X**
*X****XX*X*XX**XXX***XX*X***X***X**X*X****X**X****XX*XX**X*X*XX***XXX**X**XX**X*
*XX*X***X**X*X*****XX***XXX**XXX*X*XX*X*XX*X*X*X*X***X**X**X*X**X****X*XX**X*X**
**X*XXX*X*X**X*XXX***XX***X*X****X******X**X*X**X**XX**X**XXX**X*XXX*X**XX**X**X
*XX***XXX**X*X****XX***XX**X**X*X*XXXXX***X***XX**X***XXX**X**X****X**X***X***X*
***XX****X*X**XXX***XX*X*X***X**X*******XXX*X**X*X**X**X*X**X**XX*XX*XXXX*X*X***
XX***XXX*X**X***X*X*X*****XXX*X**XXX*XXX***X**X**X*X*X*****XXX*X**X***X***XX*XXX
**XX***X*X*X**X****X**XXX*X***X*X***XX***X**X*X*X*****XX*XX*X***X**X*X**XX******
*X***XX**X*X*X*XXX*X*X**X*X*XXX***X****XX*X***X*X*XX*X**X*****X**X***X*X***X*XX*
*X*XX*X*XX*X*X****X**XX***X****XXX*XXX*X***X*XX**X***XX***X*X*XX*X*XX****XXXXX**
*X**X*X****X*X*XXX**X*XX*X**XX*****X***X*X**X***X**XX***XX*X*X***X**X*XXX**X***X
**X*X**XXXX**X***X*X******X**X*X*X*X*XX**XX***XX**X**X*X*****X*XX*X*X*****X**X**
X*X*X*X***XX**XX*X*XX*X*X**X*X**X*X**X**X**XXX*X*X*X***X*XX*X**X****X*XX*X**XXX*
****X**XX***X**X*X***XX**X**X**X****X*X**X*****X****X*X**X**X*XXX*XX***XX**X*XX*
*X*X*X****X***X**XXX***XX*X***X**XXXX*X*X**X*XXXXXX**X**X**X***X***X*X**X*X*****
**X****XXXXXXX**X***XX****X*X**X*X****X**XXX***X****X**X**X**X*XXX**X*X*X*X*X*XX
X**X*X*X**X****XX*X*X**XX**XXXXX***XX**X****XX***X*X**XXX**X*X***XX****XX*X**X**
*X**X***X***X*X***X*X*X*XX**X***XXX*X*X*XXX***X*X****X*X*X*X**XX**XX*X*X**XX*X*X
**X*X*XX**XX*XX*XXX**X****X***X*X*****X****XX**X**XXXX***X*XX*X*X**XXX***X*X*X**
X*X*X****X******X**X**XX*X**XXX**XX*XX**X*X**X**XXX***XX*X**X****X****X*XX***X*X
**X**X*X*X*XX*XX*X**X**X***X***X******XX***X**X*****X**X***X*XXX*XX*X**X***XX**X
*X*X**X**X***X***XX**X*X*X*X*X**XX*XX*X**X**X**X*XXX**X**XX**X*X***X*X**XX**XX**
*X**X**X**XX**X*X***XX**X**X**X***X***X*XX*X*X**X****X**X**X***XXX*X*XX***X***X*
***X**X**X**X*X***X*X*X**X**X*X*X*XXX***X******X**XXX*X***X**X***X*X***XX**X*X**
XX*X*X*X*XX*X**X*XX****X**XXX**X*****XXX**XXXX**X******XX**X**XX*X**XX**X*XX***X
***X*X*X*****X**X***XX***X***X**XXXX*X***X***XXX**X*XX*X*X*XX*XX**X*XXX*X***XXXX
*XX**X***XXXX*X*X*XX***X***X*X*X***X*X*XX**X****X**XX**X*X**X***X*X**X***XX****X
****X*X*X*******X***XXX*X*X****X*X*X*X*X**X*XXX*XXX***X**X*X**XXX**X*XXX***XXX**
*X*X**X*X*XXX*X**X*X*****X**X*X**X*X**XX*X****X***X*XX*X*X*X*X***X******X*X***X*
**X*X***X*X****X**X**X*XX**X*XX*X**XX*X**X*XX**XX***X**X*X*X*X*X*XXXX*X*X***XX**
X*X***XX**X*XX*XXX**X**X**X*****X*X*X***XX*X*X*X*X*X*X***X*XX**X*****X**XX*X***X
**X*X**X*X**X*X****X**XXX**XX*XX**X**XXX*****X****X****X*X****X*X*X*X**X***X*X**
*XX**XX**X*XX*X*XXX**X*X**X*****X**X*X***XX*X**XX***X*XX**XXXX***X***X***X*X**X*
*X**X***X*****X***X*XX***X**XXXX*X*X***X***XX*X**XXX*X***X***X*X**X*X*XXX***X**X
*X*X**X**XXX*X*XX*X***XXX**X*****X**X*X*X*X***XX*****X*XX**X***XXXX*X*****XX*X**
**X**X**X***X***X**XX*****X**XXX**X**X**X*X*XX***XXX*X**X*X*X*X*****X*X*X*X***X*
X*X*X*XX**X***X**X***XX*XX*X*X**X*XX*X*X**X**X*X****X**XX***X*X*X*XXX**X*X**X*X*
X*X******X**XX**XXXX*X*X***X**X******X**X*XX*XX**XX***X**XX*X***XX***X***X*X****
**X*XXXXX**X***XXX***X***X**X**XXXXXX*X*X**X***X***X*X*X**X**XXX***X**X*X**X*X*X
X**X*****X*X*X**X**XX**X**X**X*X****X****X*XXX*X*X*X****X**X*****X*X*X*X**X*X***
*X***XXX**XX**X*X*XXXX**X*XX*X***XX*XXX*XX***X**X***XXX**X**XXX*X*X**X***X***XX*
**X*X***X***X**X**XXX*X**X***XX*X*X***X***XX*X*X**XX***X***X**XX***X**XX*X*X*X**
X**X**XX*XX*XX***X*X***X*X*X***X***XX*X*X****X**XX***X**XX**X****X**X*X**X*X*X*X
*X***X****X**X*XX****XX**X*XXXX**X**X*X**XXXX*X*X**XX*X**XX**X*XX*X*X*X*X**X*X**
*XX*X**X*XXX*X**X*X*X***X*******XX*X**X*X***X*X***X****X***X*XX*****X*X**X*X*XXX
******X***X**XX*X*X***XX*XXX*X*X***X*X**X*X****XX*X*XX*XX*X*****XXX*X**X***X****
*XXXXX**XX**X*X*X*X*XX******X*X**XX**X*X***X*X*X*X**X***X**X*XXX***X**X**X**X*X*
*****X*XX**X****X**X***XX*X***X*X***X**X*XX**XX***X**XX**X*XX****X*X*X**XXX**X**
XXXX*X****X**X*XX*X**XX***X*X*X**X*X**X**X**X***X*XX**XX*X**X*XX*X*X**X**XXXX**X
*****XXXXX*X**X****XXX**XX*XX**X*X**X*X*X**X**X*X***X**X**X*X***X****X*X**X***X*
*X*X********X*X*XX*****X******X**X*X**X*X*X*X**X*XX*XX**X*X*XXX**XX*X****X**X*X*
**X*X*XXX*X*X*X*X*XXXXX**X*X*X**X**X*X**X****X****X****X**X****X***X**X*X**XX*X*
*X***X***X**X**X******X*X***X**X**XX**X**XXX**X*X**XXXX**X*X*X*XXX**X**XX*XX**X*
X**X*X*X**X**X***XX*X**X**X*X*XXX*X*X**X****X****X*X****X****X****X*XXX***X**X**
**X**X**X**X**X*X*X*XX**X**XX**X**X**X**XX*X*X*XX*X**XXX*X*X**X*X*X***X*XX*X*X*X
*XX*X*X*XX**X**X******X*X*X***X**X**X*X**X****XX****X*****X**X*X***XX*X*X****X**
***X*****X*X*X*X*X*XXXX**X**XX**X*X****X**XX*X***XX*X*XXX***X****XX***X*X*X*X*X*
*X*XX*XX*X***X*X**X****X***X***X****XX*XX*X*XX*X**X*X*X**XX**XXXX*X*XXX*X*XX**X*
*X****X*X*X*X**XX*X*XX**XX*X*X*X*X*X**X***X****XX**XX**X****X*******X***X***X***
*X*XXX****X**X***XX*X**X*X**XX*X*X***X**XX**XXX**X***X*XXXX*X*XXXXXX*X*XXXX*XX*X
**XX***X*XXX**XX*X**X*X****X***X*X*XXX*X**X*X***XXXX*X*****X**X******X**X*X**X**
X***XXX***X*X******X***XXXXX*XX**X*******X**X*X**X*X*XXXXX**X*XX*XXX*XX*X*XX*XX*
**X*****X****X*XX*X**X*******X**X**X*X*X***X***X**********X******X******X*******