*******X**X*X****X****X******X**XX*X***X******X***
XXXX*X***X***X*X**X*X***XXXX*XX*****XX***XXXX***X*
****XX*X***X***X*X**X*XX***X****X*X***X*X***XXX**X
X******X*XXXXXX**X*X*X******XX****XX****XX*X***X**
**X*XXX****X****X**X***X**X*XXXXXX****X**X***X**X*
X**X****XX*X**XX**XX*X*X*X***X*****XXX*X**X*XXX***
*X****X****X*X**X*X******XXX**X***XX***XX**XXX***X
*XXXXX*XXXX****X**X*XX**X***XXX**X***X***X**X**X**
*****X*****XX*X**XX**X*X**X****X***XXXXX**X*X****X
*XXX***XX*X***X*XX**XX***X*X***XXXXX*X***X**X**X**
*X**X*X***X*XX****X***XX****XX*******X*XX*X**X*XX*
***X**X*XXX*X**XX*XXX*X***X***XX*X*X*X*X****XX**X*
*XXX*X**X***X*XXX****X**XX*XX****X**X**X*X*X****X*
X****X*X**XX***X*X****X*****X*XX***X**XXX**X****X*
**XX**X**XX**X*X**X**X**XXX**X***XX**X*X**********
*X**X*X*X***X**XX***XXX***X*X**X*X**X***X*X*X**XX*
*X*X**X**X*X**X***X**X*XX*X*X*X**X*X**X***XX*X**X*
****XX*X**X*X**X***X*X*X**X***X*X**X*XXXXX*****X**
*XX*****X*X**X*X***X*X***X*XX*X*X*X***X***X*XX**X*
*X*XX*XX***X*****X***X*X*****XX*X**X*X**X*X***XXX*
****X***X*X*XXXX**X**X**XXX*X***X*X**XXXX***XX****
*X*X*XX***X*****XX**X*X***X*X*XX*********X*X***X*X
*X*****XXX**X*X*X**XX**X*X**X***XXXXX*XX***X*XX*X*
X*XXX*X****X**X**X***X***XX**XX*******X**X*X*X****
****X***XXX*XX*X*X*X**X****X***XXX*X*X**X*XX*X*X*X
*XXX*XXXX******X*X**X*X**X**X*X**X**X**X*****X*X**
*X********XX*XX**XX*X*X*XXX***X*XX***X*XX*X*X***X*
***X*XXXX****X**X*X*X*X**XXXXXX***XX*XX****X**X*X*
*XX**X***X*XX**X***X**XX**X****XX*****X*XX***X*X**
***XX**X*X**X*X******X**X***XX***X**X*X***XXXX***X
X*X***X**XX*X***X*XXX**X*XXX**X***X*X**XX*X***X*X*
**X*XX**X****XXX******XX*X***X**X****X****X*X*X***
*XX******X*X*X***X*XX****X*X***X***X**X*XX**X*XXX*
***X*X**XX*X*X*XX*X***XXXX**X*XXX**XX**X*XX*X*****
*X*X*X*X***X*X**X*X*X*****X**X*X*X***X*X****XX*XX*
***X*X*XX*X***X***X****XX***X*****XX*X*XXX*X**X***
X*X**X*****XXXX**X*XXXX**XXX**XXX****X***X**X***X*
**X*X*X*XXX***X***X***X*X***X*X***X*X*XX*X*X**X**X
*XX****X****X***X*X*X****XX***X****X***X*X*X*X*X**
*X**X**X*X*XXX****X**XXX***X*X*XXXX**X*X*X**X***X*
X**X**X**XX*X*XX*X*X****X*X*********X**X*XX**XX*X*
*****X**X*****X*X****XX*X*X*X*XXXXX*X*X****X**X***
****X****X*XX*X**XX*X***X*XX**X****XX*X*XX*X*X**XX
*XX****X*X**X**X****XXX*X***XXX**X****X*X**X*XX***
*X**X*X**X*X*X*X*X*X****X*******X*XXXX*X**X****XXX
**X**XX*X**X*X*XX**X*XXX*X*XXX*X*********X*X*X****
*X**X***X*X**X***XX**X*X******X**XX*XXXX******XXX*
*XX*X*X*X**X*X*X*****X*X*X*XX**X***X*****XXX*X****
***X***X**X***X*XXXXXX****XX*X*XXX*XXX*X****X**XX*
*X*******X**X**********XX****X**********X*X***X***