**X******X*****X***X****XX***XX*******X***********
X**XXX*X*X*XX*X**X***XX****X***X*XX*X*X*XX*XXXX*X*
**X****X**X***X*X*XX*X*X*XX*XX*X**XX**X***X*****X*
*X**XX**X***X*X*X**X****X****X**X***XX*XX*X*XX*X**
**X***X**X*X**X***X*XX*X**XX*X*X**X****X**X**XXXX*
X**XX**XX*X**XXXX***X**XX**X*X**X*X*XX***XXX***X**
*X***X*****X**X*X*X**X***XXX**X*X**X**X*X*X**X*XXX
**X*X*XXXX**XX***XXX*XXX*X***XX**X*XX**X***X*X****
X*X*X****XX**X*X**X****X*X*X*X**X*****X**X**X**XX*
**X***XX***X****X***X*X**X**X**X**X*X*X*X**X**X***
*X*XXXX*XX**X*XX*XXXXX**XXX***X*XXX**X**X*XXX*X*X*
********X*X*X*X*****X**XXX**XX*****XX**X***X**X**X
*XXXX*X*X*X**X**XXX***X*X**X*X*X*X*X**X**X**XX*X**
*X***X**X**X***XX**X*X**X*X**X*X*X**X**X**X*****X*
***X*X*X*X**XXXX**X*X*X***X*X**X*XX**X**XXXX*X*X**
*XX**X*X***X*****XX***X*XX****X****X**X***X*X**XX*
X***X****X**X*XX***X*X****XXXX*X*X**X*X*X*X**X****
**XX*XXXX**X***X*X***X*X*X******XX*X**X*X**X*X*XX*
X*X*****X*X**X*XX*X*XX**X**XX*X****X*XX*XX*X**X***
**X*XXX*X*X*XX*****X***X**X**X*X*X*X***X****X***XX
*X****X***X*X*XX*X***XX**XXX****XXX*XX*X*XXX**XX**
*XXXX**X*XX*X***X**XXX**X*X**XX**X**X**X*X***X**X*
*****X*XX***X*X**XX****X****X*XX***XX*X**X*X*XX***
*XXX*XX***XXX**X***XX*X**XXXX**X*X*X**XX**X***XXX*
***X**X*XX***X**XX****X*X****X***X*X*X**X*XXX***X*
XX**X*X*XX*X**X***X*XX*X**XX**X*XX*X***XX****XX***
***XX*X****X*X*X*X*X*****X**X***X***XX***XXX*X*XX*
*XX****XX*XX*X***X***X*XX*X**XXX**X***XX*X***X**X*
X***XXX**X***XX*X**X**X*****X****X**X**X***XX**X**
X*XX***X*X*XX*X**X**XX**XX*X**XXX*XXXX*X*X***X**X*
***X*X*****X****X*X*X**X*X***X******X*XX**XXX*X***
*X*X**XXXXX*XX*X*****X***XX*X**X*XX******X*****X*X
*X*X*X****X****XXXXX**XX***X**XX*X*X*XXX*X*X*XX**X
**XX**X*X***X*X*****X**XXXX**XX****XX***X**X***X**
X***X**X**XXX***X*X**X******X***X*X***X**X**XX**X*
**XX*X*X*X***X*X*X**X**XXXXXX*XX*X**XXXX**X*X*X*XX
*XX****XX**X*X*X**X**X*X*****X****X***XXX*****X***
*X**XXX***X**X**X**X*X*X*XXX***XX**XX**X*X*XX**XX*
*X*XX***XX*X**X**X*X**X**X**XXXX*X***X***X*X*X**X*
*X***X*XX***X*XX***XX*X*X**XX****X*X**XX**X***XX**
**XX*X***XX*X**X*X**X*****X***X*X**X*X*XX*X*X****X
X**X*XXX*X***X**X*XXX*X*X*XX*XX**XX*****X*X**XXX*X
**XX***X**XX***X*****X**XX***X*X***XXXX***XX*X****
*X**XX**X***X*XX*XXX*X*X***XX***XX*****X*X***X*XX*
*XX**X*X*X*X*****X***XXX*XX***X***XXXX**X**XXX**X*
****XX*X***X*XXXX*XX*****XXX*XXXX****X*X**X***X**X
X*X*X****XX*X***X***XXXXX*X**XX**XX*X**XX**X*X*X**
***X**XXX***X*X***X*****X***X***X*X*X*X**X*X*X*XX*
*XX**X****XX***XXX*XXXX*X*XXX*X*X*X*X***X**X****X*
****X**XX****X********X*******X***X***X***X**XX***