*X*************X***************X*******X***********X*******X***X*********X*******X***X**************
*XXX*XXXX*XXXX*XXX*XXXXXXXX*XX*X*X*XXX**XXXX*XXX*X*X*X*XX*XX*X*X*XXXXXXX*X*X*XXX*X*X*X*XX*XXXXXX*XX*
***X*****X*********X*******X***X*X*X*X*X***X*X***X*X*X***X***X***X*****X*X*X*X*X*X*X*****X*****X***X
XX*X*XXX**XXXXXXX*X*XX*XXXX**XX*XX*X*X*X*X*XXX*XX**XX**X*X*XX*XXX*XXXX*X*X*X*X*X*X*XX*XXXX*XXX*X*X**
***X***X*X*******X***X*****X*******X***X*X*****X*X***X*X*X*X***********X*X*X*X*X*X***X*****X***X*X*X
*XXX*XXX*X*XXXXX*X*X*XXXXX*XX*XXXXX**XXX**XXX*XX*XXX*XX**X**XXXX*XX*XX*X*X*X*X*X*X*XXX*XXXX**XX*X***
*X***X***X*****X*X*X*****X***X*****X*****X***X*****X***X***X***X***X***X***X*X***X*X***X***X*****X*X
*XXX*X*XXXXXXX*X*X**XXXX*X*XXX*XXX*XXXX*X*XX*X*XXX*XXX*X*XXX*X**XX*X*XX*XXX**X*XX*X**XXX*XX*XXXX*X**
***X*X***X*****X*X*X*****X*******X*****X*****X***X*****X*****X*X***X*X*****X*X*****X*X*********X*X*X
XX*X**XX*X*XX*XX*X*XXX*XX**XX*XXX**X*X*X*X*XXXXX**XXX*X*X*XXXX*X*XX*X**XXX*X**XXXX*X*XXX*XXXXX*X*X**
*X*X*X***X***X***X***X***X***X***X*X*X*X*X***X***X***X***X*****X*X***X*X***X*X*****X***X*****X*X*X*X
*X*X*X*XX**XXX*XX*XX*XXX*XXXXX*X*X*X*XX**XXX*X*XXX*X*X*X*X*XXXXX*X*X*X*X*XXX*X*XXXXXXX**X*XX*X*X*X**
*X*X*X***X*X***X***X***X*******X*X*X***X***X***X***X***X*X*X*****X*X***X*X***X*****X***X*X***X*X***X
*X*XX*XX*X*X*XXX*X*XXX*X*XXXXXX**XX**X*XXX**XXXX*X*XXXX*X**X*XXXXX**XXX**X*XX*X*XX*X*XXX*X*XX**XXX**
*X*****X***X*X***X***X*X*X*****X***X*X***X*X*****X*******X*X*******X***X*X*****X*****X***X***X***X*X
*XXXXX*XXX*X*X*XX*XX*X*XXX*XXX*XXX*XX**X*X*X*XXXX*X*XXXX*X*XXXX*XXXX*X*X**XXXX*XX*XXXX*XX*XX*X*XXX**
*****X***X*X*X*****X*X*******X***X***X*X*X*X*X*****X***X*X*****X*****X***X***X***X*****X*****X*X***X
*XXX*XXX*X*X*XXXXX*X*XXXX*XX**XX**XX*XXX*X*X*X*XXX*X*X*X*XXXXX*X*X*XX*XXX**X*XXX*X*XXX*X*XX*XX*X*XX*
***X*****X*X*******X*****X***X*X*X*******X*X***X***X*X*X*******X*X*X*****X*X***X*X*X***X***X***X*X**
XX*XXXXXX*X*X*XXXXX*XXXX*X*XXX*X**XXXXXXX***XXX**XX*XX**XXXXXXX**XX**XXX*X*X*X*X*X*X*XX*XX*X*X*X*X*X
*X***********X***********X*****X*X*******X*X***X*X*****X*******X***X*X*X***X*X*X*X*X*******X*X*X****
*XXXX*XXXXXX*X*XXXXXXXXXX*XX*XXX*X*XXXXX*X*X*X*X*X*XXX*X*X*XXX*X*X*X*X**XXXX**XX*X**X*XXX*XX*X*XXX*X
*****X*****X***X***********X*X***X*X***X***X*X*X*X***X*X*X***X*X*X***X*X*****X***X*X*X***X***X***X**
*X*X*X*XXXXXXXX**XXXXX*XXX*XXX*X*X*X*X**XXXX*X*X*XXX*X*XX*XX*X*XX*XX*X*X*XXXXX*XXX*X*X*X*X*XX*XXX**X
*X*X***X***X***X*****X***X*****X*X***X*X*****X*X*****X*******X*****X***X*X*****X*****X*X***X*****X**
*X**XXXX*X*X*X*XX*XX*XXX**XXXXX**XX*XX**XXXX*X*XXXXXX*XXXXX*X*X*XX**XXXX*X*XXXX*XX*XXX**XXXX*XXX*X*X
*X*X*****X***X***X*****X*X*****X***X***X*****X*************X***X***X*****X*X*****X*X***X*****X***X**
*X*X*XXXX*XXX*XX*X*XX*XX*X*X*XX*XX*X*XX**XXXX*XXXX*XXXXXXX*X*XXX*XXX*XXXX**X*XXX*X*X*XX**XX*X**XXX*X
*X***X*********X*X***X***X*X*X***X*X***X*********X*X*****X***X***X***X***X*X*X*X*X*X***X***X*X******
**XXXX*XXXX*XX*X*X*XXX*XX*X**X*X*X**XX*XXXX*XXXX*XXX*XXX*XXXX**XXX*XXX*X*X*X*X*X*XXXXX*XXX*X*XXXX*X*
*X*****X***X***X***X***X***X***X*X*X*X*****X***X*****X*X*****X*X*******X*X***X*X***X*****X*X*****X*X
*X*XXXX*XX*X*XX*XX*X*XXX*X*XXX*X*X*X*XXXXX*X*X*XXXXX*X*XXXXX*X*XXXXXX*XX**XXXX**XX*X*XXXXX*X*XXX*X**
*X*X*******X*****X*X*X***X***X*X***X*****X***X*****X*******X*X*******X***X*****X***X*X*****X***X*X*X
XX**XXXX*X*XXXXX*XXX*X*XX*XX*XX*XX*X*X*XX*XXX*XXXX*XXXXXX*XX**XXXXXX*X*X*XXXXX*X*XXX*X*XXXX*XX*X*X**
***X*****X*****X*****X*X***X*****X*X*X***********X*******X***X*****X***X*****X*X*X*************X*X*X
*XXX*XXXX**XXXXX*XXXXX*X*X**XXXX*X*XX*XXXX*XXXXX**XXX*XX*X*XXX*XXX*XXXXXXXXX*X*X*X*XXXX*XXXXXXX**X**
*X*******X*X*****X*****X*X*X*****X*********X*****X***X***X*X***X*X*****X*******X*X*X***X*******X***X
*XXXXXXX*XXX*XXXX**XXXXX*XX**XXXX*X*XXXX*XX*XXXXXX*X*X*XXX*X*XXX*X*X*XXX*XXXXXX***XX*X*X*XX*XX**XXX*
*******X*****X***X*X*******X*******X***X*X*********X***X*****X***X*X*X***X*****X*X***X***X*X***X****
XXXXXX*X*XXXX*XX*X*X*XXXXX*XXXXXXX*X*X*X*X*XX*XXXXX*XXXX*XXXXX*X*X*XX**XX**XXX*X*X*XX*X*XX*X*XXX*X*X
*******X*********X*X*****X*******X*X*X*X*X***X***********X*****X*X***X***X***X***X*X***X***X*X***X**
*XXXX*X*XXXX*XXXX**XX*XX*X*XXXXX*X*XX**X*XXX*XXX*XXXXXXX*X*XXXX**XXX*XXX*XXX*XXX*X*X*X*XXX*X*X*XXX*X
*X***X*****X*X***X***X*X*X*X***X*X***X*****X***X*X*****X***X***X***X*******X***X*X*X*X***X*X***X****
*X*X*XXX*X*X*X*X*XXX*X*X*X*X*X*XX*XX*XXXXXX*XX**XX*XXX**XXX**XXXXX*XX*XXXXX*XX**XX*X*XXX*X**X*XX*X*X
***X***X*X***X*X*****X*X*X***X*****X*********X*X***X***X***X***X*****X*********X***X***X***X*X***X**
*XX*XX**X*XXX**XX*XXX**X**XXX*XXXX*XX*XXX*XX*X*X*XX*XX*X*X*XXX*X*XX*XX*XXX*XXXX**XX*XX**XX*X*X*XXX*X
*X*****X*****X***X***X***X*******X***X***X*X***X*****X***X***X*X*X*X***X***X***X*X***X*X*X***X*X****
*X*XXXXX*XXX*XXX*XXX*X*XX*XXXX*X*X*X*X*X*X*XXXX*XXXX*XX*X*XX*X*X*X*X*XX*X*XX*X*X*X*X*X*X*XXX*X*XXXX*
*X*********X***X***X***X*******X*X*X***X***********X***X*****X*X*X*X*X***X***X*X***X***X*****X*****X
**XXX*XXX*X*XX*XXX*X*XX**X*XX*XX*X*XXXXXXXXXX*XXXX**XX*X*XX*XX*X*X*X*X*X*X*XX**XXXXXXXX**XXXX*X*XX**
*X***X***X*******X*X***X*X*X*X***X*****X*****X***X*X***X***X*******X***X*X*X*X*****X***X*X*****X***X
*XXX*X*X*X*XXXXX*X**XX*XXX*X*X*XX*XX*X*XXXXX*X*X*X*X*XX*XX*X*XXXXXX**XX**X*X*X*XXXXX*X*X*X*X*X*X*X**
***X*X*X***X***X*X*X*******X*X*X***X*X*****X***X***X*X***X*X*X*****X***X*X*X*X*******X***X*X*X*X*X*X
XX*X*X**XXX**X*X*X*XXXXXXXX**X*X*X*XX*XXXX*X*XX*XXXX*XXX*X*XXX*XXX*XXX*X*X*X*XXXX*XXX*XXX*X***XX*X**
*X***X*X***X*X*X*X*********X*X*X*X*********X*X*********X*X*****X*X***X*X*X*X*****X*********X*X***X*X
**XX*X*X*X*XX**X*XXXX*XXXX*X*X*X**XXXXXXXXX**XXXXXXX*X*X*XX*XXX**XXX**XX*X*XXX*X*XX*XX*XXX*X*X*XX*X*
*X***X***X***X*******X*****X***X*X*********X*******X*X*X***X***X*****X***X*****X***X***X*****X******
*X*XX*XXX*XX*XXXXX*XXX*XXXX*XXXX*X*XXXXXXX**XXX*XX*X*X*X*XX**X*X*XX*XX*XX*XXXXX*XX*X*XX*XXX*X*XXXX*X
*X*X*******X*****X*X***X*********X*X*******X***X***X*X*X***X*X*X***X***X*********X*X*X*****X********
*X**XXXX*X**XXXX*XXX*XX*XX*X*XXXX*X**XXXXXXX*X*X*XX*X**XXX*X*X*XXX*XXX*X*XXXXX*XXX*X*X*XXX*X*XXXXXX*
*X*X*****X*X***X*****X***X*X*X*****X*X*******X*X*****X***X***X***X***X*X*X***X*****X*****X*X*X*****X
*X*X*XXXX**XXX*XXXXXXX*X**XX*X*XXX*X*X*XX*X*XX**XXXX*XXX*XXX*XXX*XXX*X*X*X*X*XXXX*X*XX*XXX*X*X*XXX**
*X*X*X***X***X*********X*X***X***X*X*****X*X***X***X***X***X***X*****X*X*X*X*****X***X*X***X*****X*X
*X*X*XXX*XXX*XXX*XXXX*X**X*XX*XX*X*XX*XX*X*X*XXX*X*XXX*XXX**XX**XXXXX**X*X*XXXXX*X*X*XXX*X*XX*XXXX**
***X***X***X***X*****X*X*X*******X***X***X*X*X***X***X*****X***X*****X***X*****X***X*****X***X*****X
*XX**X*X*XX*XX*XXXXX*X*X*XXXXXXX**XX*X*XXX*X*X*XX**XXXXXX*XX*XX*XX*XXX*XXX*XXX*XXXXXXXX*X*XX*X*XXX**
***X*X*X*****X*****X*X*X*******X*X***X*X***X***X*X***X***X***X*****X***X*****X*****X***X***X*X***X*X
XX*X*X**XXXX*XXXXX*X*X*XXXXXXX*X*X*XX**XXX*XXXXX**XX*X*X*X*XX*XX*XXX*XX*XXXXX*XXXX*X*X*X*X*XX*XX*X**
***X*X*X***X*****X***X*******X*X*X***X***********X*X***X***X***X*****X*************X*X***X*****X*X*X
*XX*X**X*X*X*XXXX*XXXXXXXX*XX**X**XX**XXX*XXXXXX*X*XXXX*XXX**X*XXX*XXX*X*XXXX*XXX*XX**X*X*XXXX*X*XX*
*****X***X*X*********X***X***X*X*X***X***X*******X*********X*X***X*****X*X***X***X***X*X*****X*X****
XXXX**XXXX**XXXX*XXX*X*X*XXX*X**XX*XX**X*X*XXXXXXXXXXX*XXX*X**XX*X*XXXX*XX*X*X*X*X*XX**X*XXX*X*XXX*X
*****X*****X***X*X*X*X*X*****X*X***X*X*X*X*X*****X*****X*X***X*X*X*X*******X*X*X***X*X***X*X*X******
*XXXXX*XXXXX*X*X*X*X*X**XXXX*X*X*XXX*X*X*X*XXX*X*X*XXXX**XXXXX*X*X*X*XXXX*XX*X*XXXX**X*XXX*X**XXXX*X
*******X*****X***X*****X***X*X*X*X*****X*X***X*X***X***X*********X*X*X***X***X*****X*******X*X******
XXXXX*XX*XXX*X*XX*X*XXXX*X*XXX*X*XXX*XXX**XX*X*XX*XX*X*X*XXXX*XXX*X**X*X*XXX**XXXX**XXXXXX*X*X*XXXX*
*****X*****X*X*X***X*****X*****X***X*X***X***X***X***X*X*X***X*****X***X***X*X*****X*****X*X*X*X***X
*XX*XX*XXXXX**XX*X*X*XXXX*XXXXX*XX**XX*XXX*XX*XX*X*XX*X**X*X*X*XXX*XXXXXXX*X*X*XXXXX*XXX**XX*X*X*X**
***X***X*****X***X***X*************X***X***X*****X*****X*X*X***X*X*****X***X*X*******X*X*X***X***X*X
*X*X*XXX*XXX*X*XX*X*X**XX*XXX*XXX*XX*XXX*XX*XX*XX*XXXX*X*X**XXX**XX*XX*X*XXX*XXXXXXX*X*X*X*XX*X*XX**
*X***X***X***X*****X*X***X***X***X***X*********X*****X*****X***X***X***X*X*********X***X*X*****X***X
*XX*X**XX*X*X*XXXX*X*X*X*X*X*X*X*X*X*X*XX*XXXXXX*XXX*X*XX*XX*X*X*X*X*XXX**XXXXX*XX*XXX*X**XXXX*X*XX*
***X*X*****X*******X*X*X***X***X*X*X*****X*******X*X*X***X***X*X*X***X***X*****X*X***X*X*X***X******
XX*X**XXXX*X*XXXXXXX*X**XXX*XXX**X*XX*XXXX*XXXXXXX*X**XXXX*XX**XX**XXX*XXX*XXX*X*XXX*X*X*X*X*XX*XX*X
*X***X***X***X*******X*X*******X*X***X*****X*******X*X*****X*X***X*X***X***X***X***X*X*X***X***X****
**XX*X*X**XXX**XX*XX*X*X*XXXXXX***XXX**XXXXX*XXX*XXX*X*XXXXX**XX*X*X*X*X*XX**XX**X*X*XX**XX*XX*XXX*X
*X***X*X*X***X***X*X*****X*****X*X***X*X*****X***X***X*X*****X*X*X***X*X***X***X*X*X***X*X***X***X**
*X*XXX*X*XXX*XXX*X*XXXX*XX*XXX*X*X*X*X*XXXXX*XXXX**X*X*X*X*X*X*X*XXXX*X*XX**XX*X*X*XXX*XXX*X*XXX*X*X
*X*X***X***X*****X*****X***X*X*X***X*X*****X*****X*X*X*X*X*X***X*********X*X***X*X***X*****X*****X**
*X*X*XXXXX*X*XX*XX*XXX*X*XX**X*XXXX**XXXXX*XXX*X*X*XXX*X*X*XXX**XXXXXXXX*X*X*XXX**XX*XXXX*X*XXX*XX*X
*X***X*X***X*X*X***X***X***X*X*****X*****X***X*X*X*****X*X***X*X*******X***X*X***X*X*****X*****X****
*XXXX**X*XX**X*X*XXX*X*XXX*X*XXXXX*X*XXXX*XX*X*X*XXXXXX*XXXX*X*XXXXX*X*XXXX**XXX*X*XX*XX*X*XXX*X*XX*
*****X*X*X*X*X***X***X***X*X*******X*******X*X*X*********X***X*****X*X*****X***X*X***X***X*X*X***X*X
*X*X*X*X*X*X*XXXX**XX**XXX*X*XX*XXX*XXXX*XX***XX*XXXXXXX*X*XX*X*XX*XXXXXXX**XX*X**XX*X*X*X*X**XXXX**
*X*X***X*X*X*****X***X*X***X***X*******X***X*X***X*****X***X***X*****X***X*X***X*X***X*X*X***X*****X
*X*XXXXX*X*XXXXX*XXX**XX*XXXXX*X*X*XXX*XXX*X*X*XXX*XXX*X*XXX*X*XXXXX*X*X*X*X*XX**X*XX**XX*XX*X*X*XX*
*X*******X***********X***X*X***X*X*X*X***X*****X***X***X*X***X*****X***X***X*X*X*X***X*******X*X****
*XXXXXXXX*XXXXXXXXXXXX*XXX*X*XX*XX*X*XXX*XXXXXXX*XXX*XX*XX*XX*XXXX*XXXX*XXXX*X*X*XXX*XXXXXXXX*X*XX*X
***********************X***********X*************X*********X*****************X**********************
*X*X*X*X*X*X*X*X*X*X*X**X*X*X*X*X*X**X*X*X*X*X*X**X*X*X*X*X**X*X*X*X*X*X*X*X**X*X*X*X*X*X*X*X*X*X*X*