**XX*****X********X*X****
X***XXX*X**XXXX*X***X*XX*
*XX*X****X****X*XX*X***X*
**X***XX**X*X*X***X**X*X*
X**XXX**X**XX*XXX*X*X*X**
*X****X*XX*X****X*X*X***X
**XXX****X**XXXX**X**XX**
*X***X*X*XX*****X**X**XX*
***X*X*X***XXXX*XX*X*X***
*XX***X*X*X***X**X***X*X*
***XX*****X*X***X**XX**X*
*X*X**XX*X**X*XXX*X***XX*
*X*X*X***X*X*X***X**XX***
*X**X**X*X*X***X***X***XX
*XX**XX**X**XX**XXX*X*XX*
***X*X**XXX***X*X*****X**
X*X***XX*X*X*X**X*XXXX**X
X*X*XX*****X***X**X****XX
**X*XX*XXX*XXXX**XXX*X*XX
*X*****X*X******X*X**X**X
**XXXXX***XXXX*X****X*X**
X*****X*X*****X**X*X***X*
*XXX*X**XXX*X**XX**XX*XX*
*******X*****X****X******
*X*X*X*X*X*X*X*X*XX*X*X**