****X****X*********X****X****X***X***X**X*********
X*X***XX**X*XXXXXX***XX*X*XX**XX***X*X*XX*X*X**XX*
**X*XX**X***X*****XXX*X*X*XXX**X*XX****X**X*XX*XX*
X**X***X*X*X**XX*X******X**X***X***X*X**X*X**X****
*X***X****X*X***X**XXXXX*X*X***XX*X**XXXX**X*XXXX*
*XX*X*XX*X****X*X*X****X****X*X****XX****X*X*****X
****X*X**X*XXX**X*X**X***XX*X**X*X**X*XX*X****XX**
*X*XX***X**X*X*X**XXXX*XX****X**XXX****X**X**X***X
***X**X*X*X**X**X***X****XXX**X*XX*XXX*XX**X**X*XX
**X*XXXXX*X*X****XX**XX*X***X*X*******X***X**X***X
*X****X***X*X*X****X***X**X***XXX*XX*X**XX**X**X**
***XX***XX**X***X*X*XX*X*X*XXX***X*X*XX***X*X*X**X
*XX**XXX***X*X*X**X****X*X*****X***X***XX***X*X*X*
*X**X***XX***XX**X**XXX**X*X*XXX*X*X*X*X**X*X*X*X*
***X**X****XX***X**X**X*X****X***X**X**X**********
X*X**XXX*XX***X**X*XX***X*X***XXX**X**X***XXXX*XX*
X**X**X**X**X*XXXX**X*X*X*XX*X***X*X*XX*X******XX*
***X*X**X**XX*****X*XX**X**X***X**XX****X*X*X*X***
*X**X**X**X*X**XX*X****X*X**XXXXX***X*XX*XXX**X*X*
*XX*XX*X*X****X*X**XXXXX*X*X***X**X**X****X**X**X*
**X****X*X*XXXX*X*XX*****X*X*X**X**X***XX***X**X*X
X***X*X****X****X****X*X*X****X**X**XXX***X**X*X**
**XX*X**XX***XX*X*X*XX**X*XX*X**XX*X***XX**XXX**X*
*XX**X****X******X**X*X*X**X***X***X*X***XX****X**
*XX******XXX**X*X**X**X**X**XX*X*XX***XX****XXX**X
****X*X*X*X**XXX**X*X***XX*X***X***XX***X*XX****X*
X*XX****X*X*X*X**X***XX****X*XX**X***XX**XXX*XX***
*X***XX***X*X*X*XX*X***X*X*X****XXXX*X*X**X****XX*
***XX*X*X*X***X***X*X*X**X**X*X**X******X*X*XXXX**
*X**X***X**X*X*XX***X***X**X***XXX*X*X*XX***X***X*
*XX**X****X**X****X**X****X**XX****X**X***X*X*X***
***X*X**X**X*X*X******X**X**X*X*XXX**X**XX*X***X*X
X*X**X*X**X**X*X*X**X**XX**X**X*****XX*X*X***XX***
***X*X***X*X*X*X**X*XX**X*X**X*XX*XX***X***X*X**X*
*XX**X**X*****X*X**X***XX**X****X****XX**XX****X**
X***X****X********X**X*******XX**X*XX***X*X*XXX**X
**XXX*X*X**X*XXX*X**X**X*X*X***X**X***XX**X*XX**X*
X****XX***X****X*X*X**X*X**X*X****X**X**X*X***X***
**XX*X*XX**XX*XX*X*X*X**X*X***XXX***X***X**XX*XXXX
X*X**X**X***X****X*X***X**X*X*X**XXX******X*X*****
***X*X*X***X**XXXX**XXX**X*XX**X*X***X*X*XX**X*XX*
*X*X*X***XX**X****X*****XX***X****XX**X****X**X***
*XXX**XXX***X**XX**XXXXX***X****X*****X*XX*X*X**X*
X****X***XX**X**XX*X*****XX*X*X**XXXX***X****XX*X*
X*XXX**X***X**X**X***XX*X*X*X***X****XX**XXX**X**X
**X***X*XX*X***X**X*X***X****X*****X*X**X***X*****
*X**XX***X***X**X**X*X*X*X*XX*XX***X***X**X**X**X*
***X***X**X*X*X**XX****X*******X*X**X*XXX**X**XXX*
*XX**XX*X*X****X*X**XXXX*XXXXX****X**X*X**X*X*X***
****X******X*X*****X**********X*X**X*****X******X*