**X***X****XXXX****XXX************X***X*X********X***X*****X****X**X****X****X*X
X*X*X***XX**XX**XX**X**X*XXX*XXX*X**X*****X*XXXXX**X**X*XX**X*X***X**X*X***X*X**
**X**X*X*XX****X**X*X*XXX****X****X**XX*X**X******X*X***X*X***XXX*X*X****XXX**X*
*X*X**X****XX*X**XX**X*X**X****X*XX*X*X**X*X*X*X*X***X*X**XXXX**X**XX*X*X*X*X***
*X**X*XXX*XX**X*XX*X****X**XX*XXX***X**X*X*X****X**X*X**X******XXX***X**X****XX*
**X*******X**X******XXX**X*XX**X**X*X*X**X*XX*X*X*XX*XX**XX*XX**X*XX***X**XX*XX*
***XXXX*X*X*XX*XX*X*X***X****X**X*X***X*XXX****X**X****X***X**X*****XXX**X**X***
XX****X*XX**X**X**X*X*XX**XX**XXX**XXX**XX**X****XX*XX*X*X*XX***X*X*****X**X**XX
**XXX*X**X*XX*X**X**X***X***X*X***X***X****XX*X*X****XX**X**X*X*X***X*X*X*XX*X**
X***X**X*X***X**XX*X*XX*X*X*X***XX**X**X*XX***X**X*X***XX*X**X***X*X***X*****XX*
**X**X**X*XX*X*X*****X**X**X***X***XX*X****XXX*X*X**XX****X*X**X*X**XX*X*X*XX*X*
*XXX**X****X*X**X*X*XX*X*X****X**XX***X*XXX******X*X**XXX***X*X*X*X*X**X**X*****
**X*XX*X*X*X**X*X**X***X*****X**X***XXXX****XX*XX*X**X**X*XX**X******XX*X**X*X*X
X*******XX**X*X**X*X**X**XX*****X*X*X*X**XXX**X*****X**X*****XX*X**X*X****X**X**
**XXXXX***X*X**X*X*X*X*X***X**XX*X*****X***XX***X*X***X**X*XX***XX*X***XXX**XX**
*X*****XX*X*X*XX*X*X*X*X*X*X*X****XXXX*XXX***X*X***X*X**X*XXXX*X*X*XXXX***X***X*
*X*XXX**X*X***X***X**X**X**X*X*XX*X**X***XXX**X**X*X**X*X**XX**X*X****XXX**X*X**
*X****X*X**XXX**XX**X*X***X*****X**X**XX*****X**X*X**X**XX****XX**X*X****X***X*X
*XX*X***XX****X****X****X**XX*XX*X**X***XX*XX**XX***X**X***X*X***X***X*X*X*XXX**
***X**X***X*X*X*X*X*XXXX*XX******X*X**X***X*X*X***XX**XXX*X**X*XX**X**XX*X*X**X*
XX**X**X*X**X*X**X**********X*X*X**X*X*XX*****X*X*XX*X*X**XX*X***X**XX***X***XX*
**X***X*XX*XX**X***XXX*X*X*XXX**X*X**X***XX*X****X***X**X**X******X****XXXX*X***
*X**X*X****X****X*X**XX***X*X**X***X*XX*X*X***XX***X*XX**X*XX*X*X***XXX**X*X**X*
*X*X*XX*XXX**X***XXX****X****X**X**X**X****X******X***X*XX**X*X***X*X**X*****XX*
***X****X**X*XXX**X**X*X**XX**X*****X**XX*X****X*X*X*X****X*X*XX*X***X***X*X***X
X*X**XXX**XX****X*X*X*X**X*X*X**X*X*X*X****XXXXXX***X**X*X**X***X**XX*XXX***XX**
**XX***X****X*X***X*X**XX******X*X****X*XX*****X**X***XXX**X**X*X*X******X**X**X
*X**XX*X*******X********X*XX*XX****X*X****XXXX**XX*X*X*X**X**X**X***XX*X**XX**X*
**X**X**X***XXX***XX**X*X*X*X***XXX*X**XX*X***X****X*****XX*X**X*XXX**XXX***X***
*X**X*X**XXX***X***X*X**X*****X*X***X*X*X*X*X***X*X**XXXX***X*X*****X**X******X*
*X*X***X*****X*X*X*X*X*X*X*XXX****X*X*X*X****X*X**X*X****XX*X**X*XX**X**X***XX**
***X*X*X*XXX*X*X***X******XX**X**X**X*X**XXX**X**X**X*XX***XXX*X***X**X**XX***X*
*XX**X**X***X**X*X**XXX*X****X**X**X****XX**X**X**X*X*X*XX**X***XX**X**X****X*X*
X***X*X*X*X*X*X*X*X*X**X*XXX**X**X**XXX*X**X**X*X**X**X**XX*X*XX***X**X**X*XXX**
X*XX**X***X***X*****X*X****XX**X**X***X*X*X**X**X*X**X*X****X***XX*X*X**X***X**X
****X***X*XXX**X*X*X**X**X***X**X**XX******X**X***XX*X*X*XXX**X****X*X*X**XX**X*
*XX*XXX**X***XX***XX*X**X*XX***X*X***XX*XXX**XXX*X*******X*XX**X*XXX**X**X*X*XX*
*X*X***X*X*X***XX****X**X***XXX***XX***X****XXX****X**X*X****X**X***X*X*X**X****
***X*X*XXX**XX***X*X**X*X*X**********XX**XXXXX**XXX*XX***XXX***X**X*X*X*****X*X*
X*XX*X*****X**XX**X*XX**X*XX*X*X*XX*X*X*X***X**XX*****XX***XXX*X*X*****X**X**XX*
X*X**XXXXXX**X*XX******X****X******XX*X**XX***X***XXX***XX****X**X*XX*XXX***X***
**X*X************XX*XXX*X*X*XXXX*X*****X**X*XX**XX***XX*X*X*X**X**X****XXX*XX*XX
*X**X*XXX*X**X*X***XX****XX****X**XX*X**X******X***X*X**X**X*X**X**XXX**X*******
***X**X*X*****X*XX****X****XXX**X**X****XX*X*XXX*XXX*X*X**X***X*XX****X**XXXX*X*
*XX***X**XXX******XXXXX*X*XX**X*****XXX**X***X***X***X**X***X****X*X*XXXX*****XX
*X****X****X*X*XX*******X***X**X**X****XX*XXX*X*XX*XX*X**XXX**XX**X**XX***XXX***
**X*X****X*X*X***XX*X*XXX*X***XXX*X*XX******X***X*****X*X***XX**X***X***X****XX*
X**X*XXXX**X**X*X*X**X****X*X**XX*X*X**X*X*X**X**XXXX*X***X***X*XX*XX**X*X*XX***
XX*X****X*XXX**X**X*X**XXX***XX***X**XX**X**X**X*****X*XX**XX*****X***X***X***X*
X***XXX****X*X***X**X*X****XX***XX*XX***X*X*X*X**XXX*****X*X*XXXX***XX**X*X*X**X
**X***X*XX*X**XX**X*X**X*XX*X*XX*X****XX****X**X***XX*XX**X**X***X*X***X**X**X**
X**XX**XX***X***X*X*X*X**X****X****XX***X****X**X*X***X**X**X**X*XX*XX**X**X**X*
**X**X***XX***X*X*X*X**X*X*XXXXX*X*X*XXX*XXX**X**XX*XX*X*X*XX*X********XXX*X*XX*
*X**X*XX**XX*XX**X***X*X*X****X**X**********XXX*X***X**X*X*X**X*X*XXX***XX*X*X**
X**X**X*X***X**X*XX*X**X**X*X**XX**X**XXX*X*****X*XX**X**X**X**X**X**XX****X*XXX
*****X***XX**X******X*XXX**X*X***X***XX**XXX*XXX**X**X*X*XX**X*X*X**X*X*XX*X****
*X*X*X*X***X**XXX***X**X*X***XXX**XX***X**X*X****X*X***X***X***X**X****X****X*X*
*X***X*X**X*X****X**XX***XX*X****X*XXX**X***X*X*X***X*X*XX*XXXXXX**XXX***XX**X**
***X*X*X******X*X**X**XX**X*X*XXX*****X**X*XX**X*XX***X**X*****X*X****XX**X****X
*XXX*X**XXXX**X**X**X***X*X*X***X***X**X*X***X*X***XX***X*XX*X*X***XX***XX**X*X*
*****XX*X**X*XXX**X**X*XX**X*XX**X***X*X*X*X*X***X*X**X*X***X**X*X***XX***X*X***
**XX*****X*X**X*X*X*XX***X***XXX*X*X*X****X**XXXX***XXX***X**X*X***X*X*XX*X**XX*
X**X*XXX****X*****X****X**XX**XX**XX*X*XX***X****XX****XXX*X***XX*X*******X*XX**
**X***X*XX***XXX*X**X*X*X***X***X*X***XX*XXX**XX*X**XX*****X*XX***XXXXX*X**X***X
*XX*XX**X**X****XXX**X***XX**XX*X*X*XX*****X*XX**X*X**XXX*X**X**X*****X*XX*X*X**
*X*****X**X**X***X**X**X***X**X***X**X*X*X***X**X***X***X*X*XX*X**X*X*X**XX**XX*
*X*XX*X**X**X*XX*XXX**X*X*X**X**XXXX*X**X*XXX*X**XX*XXX*X*X***X**X**X**XX*****X*
***********X***X****X*X***X*X**X**XX**X*X*X*******X*****X**XX**X*X*X*X**X*XX****
X*X*X*XX**X**X**X*X***XX*X*X**X**X***X**X**X*X**X**XXXXX**X**X*X**X**X*XX*X**XXX
****XX**X**X**X**X**XX***X**X*XX***X*X*X*X****X**X*X*****X**X***X***XX*X**X*X***
*XX***X**X**X**X**XX**X*XXX****X*XX*X**X*X*XX**XX****XXXX*X*X*XX**X*X**X*XX***X*
***XX*XX**X**X**X****X**XX**X*X*****X*XX*****X*X**X*X*******X*X**X*X**XX***X*X**
*X**X**X*X**X*X**X*X**X***XX**X*XXX*X***XXXXXX***X*X**X*XXX*X*X*X***X***XX**XX*X
X**XXX*****X***X*X**X*XXX***X*XX***X**X*X*****XXX***X*X***XX**X*X*X***X***X*X***
****XXXX*XX**XX*X**X****XXX*X****X**X*X*X*XXX*****X**X*****X*X*X**XXX*XX*X***X*X
*XX**X**X*XX*X***X**XXX***X**XXXX*X*XX**X*X**XXX*X**X**XXX*******X*****X**XX*X**
**XX***X*******X*X*X***XXX*X****X******X***X****X**X**X*X**XXXX*XXXXX*X**X***X*X
X*****X**XX*XXX****X*X*****XXXX**XXX*XX*X*XXX*X*X*X**X***XX***X**X***X**X**XX***
**X**XX*X*X***XXXXX***XXX*******X***X*****X****XX*XXX**X****X*XXXX*X*XXX**X**XX*
*XXX*******XX*******X***X***X*****X***XX*X***X********X**X*X*******X*****XXX****