**X*X******X****X*X**********X********X*********X*
X*X***XX*X**X*XX***X*XXX*X*X*X*X*XXX*X**X*XX*X*X**
X**X*X**XX*X*****X**X***X**X**X**X****X*X**X**X**X
**X***X****X*X*X**X***X*X*X*X***X*XXX*X*X*X*X***XX
X**XX*X*X*X**XX*XXXX*X**X****X*XX****X**X*X**XX*XX
*X*X**X*X**XX*****XX*X*XXX*X**X***XX**X*X**X*X***X
*X*X*XX**XX***X*X****X**X**XX***XXXXX***XX*X***X**
*X***X*X****XX*X**XXX*X**X***XXX**XX*XXX***XXXXXX*
*XXXX***XXXXX***XX*****X**X*X**XX****X*X*XX****X**
******X*X*****X****X*XX**X**X*X***X*X**X*XX*XX*X*X
X*XXXX***X*XXXXXXX*X****X**X****XX****XX****XX**X*
**X****XX**X**X***X*XXXX**XX*XXX**X*X***X*XX**X*X*
*X**X*X*X*X*X***X***X****X***X*X*X**X*X**X**X*X***
**XX**X***X***XX*XX**XX*X**X*X***X*X*XXX**X****X*X
X***XX**XX**XX***X*X*X***X*XX**X*X*X**X**X*XX*X***
X*X***X****X***X***X*X*XX*****X**X**X***X*****X*X*
***XX**X*XX*X*XX*XX**X*X**XXXXXXX**X**X**XX*X*X**X
*X***X**X*X*****X***XX**XX****X***X*XX**X***X**X**
**X*X*X***X*XXX***XXX*X***X*X***X*X***X***XX**X**X
X**X***X*XX****XXX*****XX*X*XXX**X**X**XX**XXX**XX
*X*X*X*X*X*XXX*X*XXX*X**X*X***X*X**X**X*X*X***X**X
**XX*X*******X*X******XX**XXX*X*X*X**X****X*X**X**
X*****XXXXX*X***X*XX*X***X*****X**XX**X*XX**XX**X*
*X*X*X****X**X*X***X*X*XX*X*X*XX*X**X*X**X*X***X**
****X**XX**X*X*XX*X**X*X*****X***X*X**XXX**X*XX**X
*XX***X***X**X**X*X*XX**X*X*X**XX***X*****XX****XX
*X*XXX**XX*X**X*X**X**X**XX*X*X**X*X*XXXXXX*XXX**X
******X*****X*X**X***X*X****X***X****X******X**X**
XX*XX**X*XX*XX*X**X*X**XX*X**X*X**XX**X*X*X**X***X
**X**X**X*X*****X*X***X****XX**X*X**X*X*X**XX**XX*
X***XXX*X**XXXX***X*XXX*X*X***X***X***XX*X**X*X***
*X*XXX**X*X****XXX*******XX*XX**XX**X******X***XX*
****X**X***X*X****XXXX*XX*****X***XXXXXXXX**X*X***
*XX**X*X*X*XXXX*XX****X***XXXX**X***X****X*X**X*X*
**XX*X*X*X***XX*X**XX**XX*****X*XXX*X*XXXX**X*X*X*
X**X***X**XX******X**X**XX*XX**X****X*****X*X*X**X
X*X*XXX*X***XXXXXX**X*X***X**X*X*XXX**X*X*X*X**X*X
**X*****X*X*X*****X****XX***X**X***XX**X**X*XX*X**
*X*X*XX*X*X***XX*XX*XX***XX*X*X**X***X*X*XX**X**X*
*X***X**X*X*XX***X****XX*X**X*X*X*XX**XX***X*X*XX*
*XX*X**X***X*X*X**X*X**X*X*X**X*****X*X**X***X****
**X*X*X*XX*X*X**X**X*X*X*X*X*X*X*X*X**X*XXXXX*X*X*
*X**X****X****X**XX***X******X**X**X*X***X*****XX*
*X*X*XXX**XXX*X*X***X**X*XX*X**X**X**X*X***XXXX***
***X***X*X****X*X*X**X*X*X*XXX***X**XX**X*X*****XX
X*X**XX***X*X*X***XXXX**X***X**X**X***X*X*X*XXXX**
*X*X**X*X**X***X*X****X*X*X**XXXX**XX**X**X*X***X*
****X***XX**XXX*X**XX*X****X***X*X***X**X*X*X*X***
X*X**X*X**X******X**X*XXXXX*XX*X*X*X**X**XX*XX**X*
***X*****XXX*X*X***X***********X****X**X*******X**