**X***X***************X*******X*X*************XXX*****X*X*******X***X******X****
X*XX*XX*X*XXXX*XXX*X*X**X*X*XX***XX*XXXXXXX*X**X**X*X***X*X*XX*X**X***XX*X***XX*
X**X*X**XX*****X*X**X**X**XX***X****X******XXX**X*X**XX*X*X***X**X*XXX*X*XX*X***
*X*X***X***XXXX****X**X*X****X**X*XX**XXXX**X*X***XX*X**X**XX**X*X***X*X***X**X*
*X*XXX*X*XXX***XX*XX*X***XXXX**X*X***XX***X***X*XX*X*X*X**X***X**X*X*X**XX**X**X
*X****X**X***X****X**X*X*X***XX****XX***X**XX*X****X**X*X**X*X*X*X*X***X*X*X*X**
**XXX*X*X*X*X*XX*X*X*X*X*X*X****XXX*X*XXXX**X**XXX**X***X*XX***X*X*X*XXX***X**X*
*X**X***X*X*****X*******X**XXX*X********X*XX*X****X**XX*X***XX***X**X****XX**XX*
*X*X*XXX***XXXX**XXXXX*X**X***X**X*X*XX*******XXX**X**X*XXX***XXX*X*X*XXX*X*X***
*******X*X*****X*X****X**X**X*XXX**XX**XX*X*X*X**X*XX*X****XX*X***X*X***X***X*X*
*XXXXX*X**XXX*X****XX***X**X*****X****X**X**X***X***X**XXX**X*X*X***XXX**XX*X**X
X****X*XX***X**XXXXXXXXX*X**XXXX**XXX**X*X*X**X**XX**X***X*XX*X**X*X***X*X**XX**
**XX*X***XX*XX*****XX*****X*****X*X**X***X**X**X**X*X**XXX*****X**X**X*X**X***X*
X*X***XX******X*XX***XX*X***XX*X**XX**X*X*X**XXXX*X**XX***X*XX*X*X**X***X**X*X**
**X*X***XX*XX*X***XX***XX*X*XX**X***X*****XX***X**XX****X**X*****X*X**X***X****X
X*X*XXX***X**X*XX*X*XX***X****X**XX*X*X*X**XXX**X***X*XXXX*X*X*X*X*X*X*XXX**X*XX
X**X***XX*X*X***X*X**X*X*X*XX*X*X*X**X***X****X*X*XX*X**X**X*XX*X***X****XXXX**X
**X**X*X******X*X**X**X**XXX*XX*X**X*X*X**XXXX***X*****XX*X*X***X*XXX*XX*****X**
*X*X*X*X*XXX*X***X**X*X*X*******X*XX**XX*X****X*X**XX*X***X***X***X*****XXXX**X*
*X*X*X**X***XX*X***X*****X*XXXXX****X***XX*XX*X*X*X***X*XXXX*X**XXX*X*XX****X*X*
***X**X**XX****XXX**X*XX*X*X***X*XX**XX*X**X**X****XX*X***X***XX*****X***X*XX*X*
*X**X**X**XXX*X***XX****X**X*X***X**X***X*XX*XX*X*X****XX**X*X***XXX*X*XX*****X*
*XX*X*X*X****X**X***X*X*X*X***X*X*X*X*XX**X****XXXX*XX*X**X****X***X*X*X*XXXXX**
X***X****X*X**X**XX*XX****X*X**X***X**XX*X*X*X**X****XX**XX*X*XXX*X**X*X*****X*X
**X**X*X**X**XX*X*X***XX*X**X*X**X**X****X**X*X***X*X***X***XX*X*X**X***X*X*X**X
X**X**XX*X**X***X**XX***X**X*X**XX*X*XX*X*X****XX*XX**XX**XX******XX**XX**X**X**
XX*X*X****X**XX***X**XX**X*****XX******X***X*XXX***X*X***XXX*XX*X**X*XX**X**X*X*
X***XX*XX**X***XX*X*X***XX*XXXXX**X*X*X**X***X***XXX**XX**X**X*XXX***X**X**X**X*
**X****X*X*XX*X*X*X**X*X***X*****X***X**X**X*X*XX***X***X*X*X***X*XXX*XXX*X*X***
*X**XXX**XX***X*X***XX**X*X**X*X**XXXX*X**X****X**X*XXX**X**X*X***X*********X*X*
**XX****X***XX***XX***X*X*XX**X*XX******X*XXXX*X*X*****X*XX*X*XX*XX*XX*XXXX*X*X*
X***XX*X**XX*X*X*X*XX*X*X***X****X*XXXX**X****XX**X*XX*X****XX***X***X*X****X**X
*XX**X**X****X*X******X**XX**XXX*X*****X*X*XX***X**X*X**X*XX***XX**XX**X*XXX*X**
***X***X*X*X***X*XXXXX*X***X*X*X*XXX*X**X**XXX*X*X****X**X***X*X**XX**X**X*X*X*X
*X*X*XX***X*X*X*X****X**XX*X***X****XX*X**X*X**X***X*X**X**X**XX*X***X**X****X**
X**X****X*X**X****XX**X**X**XXXXXXX****X*X***X***XXX*X*XXX**X****X*XXX*X**X*X*X*
X*X*XX*X**X*X**XXX**X***X**X***X***XXXX***XX**XXX***XX**X**XXX*XX**X****X*X***X*
******X*X*****X***X**X*X**X**X***X*****XX****XX*X*X****X**X*X*X**X**X*X**X**XX**
*X*XX****XXXXX**X**X***X*XX*X*XX**XXXX**XXXX*X**X*X*X*X**XX*****X*X**X*X***XX**X
**X**X*XX******X**X**X*X****X***X*****X****X*X*X**X**X**X***X*X*X*XX****X*X***X*
X**X****X*XXX*XXX**X*X**XX*X**X*XX*XXXX*X*X****XX**XX**X*X*XX**X****XXX**X**XX**
**X*X*X*X*X**X*X**X***XXX***X*X**XX****X***X*X**XX*X**X**X*X*X***XX*X**X***X*X*X
*X***X*XX***X***X***XX***XXX***X****XX*X*XXX**X**X*X*X*X******XXX*****X*XXX*****
*X*X******XX**X*X*XX*X*X****XX**XX*X*****X***X*X*X*X***X*XXXX***X*XX*X*****X*X*X
*X**XXXXXX***X**X*X**X**XXX**XX***XX*X*X*X*XX***X**XXX**X*****XXX***X**XX*X**X**
**X*X******XX**XX*X*XX*X***X**X*X***X***X**XX*XX**X***X**XX*XX****XX**X****X**X*
*X**X*XX*XX*X*XX**X*X**X*X**X*X**XX**X*X**X****X*X**X**X***X***XX**X*X**XX*XXX**
***X****X*****X**X**X*X***X***XX***X**XX*X**X*X***X**X**XX*XXX*XXXXX*XX*X******X
XXXXX*XX**X*XX*X**X*X*X*X**XXX**X*X**X*****X*X**X*X*X*X*XX***X**X*****X*X*XXXXX*
***X**X**X*X***X*X**X**X**X****X*X**X**XX*X***X**XX***X***XX*XX*X*XXXX**X*X*****
*X***X**X**X*X*X***X*X*X*X*X*X****X***X*X*X*X**X***X*X*XX**X**X***X***X**X**X*X*
**XXX**X**X**X***XX****X****X**XX**X*X***X**XX**XX*X****X*X**X**XX**X*X*XX*X**X*
X***X*X*X***X*XXX***XXX*XXX*X*X**X**XX*X***X*XX*XX**XXX*X**X**X*X**X**X*****XXX*
**X*X****XX*X*X***XX**X***X*X*X*X**X***XXXX***X***X***X*X*XXX**X**X*X**XX*XX****
*X***XXX*X****X*XX*XX***X*X***X*XX***XX****XX*XXX*X*XXX*X**X*X***X**XX***X***XX*
**XX*X***X*XXX**X****X*X**XX*X****XXX*X*XX*XX***X*X*****X*X***XXX*X***XX*XX*X*X*
X**X**X*XXX***X*X*XX****X**X*X*X*X******X****X*X**X*XXX*X***X******X*X****X*X*X*
X*XXX*X*XX**X***X**XXXX**X**X**X***XXXX*X*XX***X*XXX***X*XXXX*XXXX****X*XX**X*X*
***X**X****X*XXX*X****X*XXX*X*XX*XX***X*XXX*X*XX**X**X*******X****X*X*X*X**X**X*
*XX**X*XXXX****X***X*XX**X**X*X**X**X*X******X***X**XXX*XXXX***XX**XX*X*X*X*X*X*
*XX*X**X**X*XX***XX*X***X**X***X***X*XX*X*X*X**XX**X*X*X****XXX**X*X**X***X*X*X*
X***XX***X**X*XXX***X*XX**X*XX**XXX****X**XXX*X***XX*****XXX***X*X***XXX*X****X*
**XX***X*X*XX****X*X**X**X*****X****XX*X*X****X*XX***XX*XX***X****XX**XXX**X*X**
*X***XXX***X**XX*X*X*X**X*X*XXXX*XXX***X***X*X**X*X*XXX****XX*X*X***X**X**X**X*X
**X*X***X*XX*X*X*X*X*X*X****X****X*X*XX*X*X**X*X****XX*X*XXX***X**X*XX***X**X**X
X*X***X**X***X*X*X*X**X**XXX**XXX**X*****X**X**X*X*X***XX****X*X*X***X*X**X*X*X*
**XXXX*X*X*XX**X*X**X***X**X*X***X**XXXX**X**X**XX*X*XX***XX*X*X**XX****X**X**X*
*X*****X***X*X*X**X**XXX**X**XX*X**X****X**X**X*X****X**XXX*X**XX**X*XX**XX**X**
***X*X*X*XX*****X**X*****X**X*X***X*XX*X**XXX*X**X*X*X*X****X*X*X*X****XX***X*X*
XXX*X***X*XX*XX**X*XXXXX*X*X***X*X******X**X**XX*X**X**X*X*X**X**X**X*X***XXX*X*
*****XX*X****XXX*X*******X*X*X***X*XX*X*X*X**X***X*X**X**X*X*X*X***X*X**XX******
*X*X****X*XX**X**X*X*XXXX**XX**X*****XX*X*XX**X*X*X**XXX*X*X****X*X**X*X**X*X*X*
**X*X*X**X*XX**XXX*XX*****X***XXXX*X*X**X***X*****X*X*X**X**XXX*X***X***X***X*X*
X****X**X****X******X*XXXX*XX**X**X**X*X*XX**XXX*X**X**X**X***X**XX**X*XXX*X*X**
XX*XX**XX*X*X**XXXXX*********X**X*X*X**X**XX*X***X*XXX*XX*X*X*XX*X*X*X**X*****X*
XX*X**X***X*X*X*****XX*X*X*X**X***X*X*X*X**X**X*X***X*****X**X***X****X*X*X*X**X
X**XXXX*XX***XX*XXX***X*X*X*X**X*X**X*X**X**X*X**X*X**X*XX**X**X*XXXX*X*XX*XXX**
**X*****X**XX***X**XX*******X*X*X**X***X***X**XXX***XX*X***X**XXX***XXX*****X**X
*XX*XXXX*X*XX*XX*X***X*XXXXX****X*XX*XX**X*X*X****X*X****X*XX**XX*X****XXXX*XX**
*********X*********X*X*******XX***X*****X**X***X*X****X*X****X*****X*X**********